10 9 9 9 16 9 9 9 17 9 9 9 16 9 9 11
12 8 8 8 8 8 8 8 8 8 8 8 8 8 8 13
12 8 8 8 8 8 8 8 8 8 8 8 8 8 8 13
12 8 8 8 8 8 8 8 8 8 8 8 8 8 8 13
12 8 8 8 8 8 8 8 8 8 8 8 8 8 8 13
12 8 8 8 8 8 8 8 8 8 8 8 8 8 8 13
12 8 8 8 8 8 8 8 8 8 8 8 8 8 8 13
12 8 8 8 8 8 8 8 8 8 8 8 8 8 8 13
12 8 8 8 8 8 8 8 8 8 8 8 8 8 8 13
14 9 9 9 9 9 9 9 9 9 9 9 9 9 9 15
